NO textures/test/north.xpm
SO textures/test/south.xpm
WE textures/test/west.xpm
EA textures/test/east.xpm

F 20,20,20
C 200,200,200

11111
10001
10001
10001
10001
10001
11001
S0001
10001
10001
10001
10001
11111
