NO ./textures/dalles2.png
SO ./textures/Tile_04-256x256.png
WE ./textures/Tile_20-256x256.png
EA ./textures/Woven_17-256x256.png

F 50,50,50
C 15,208,217

1111111111111111111111
1S00000000000000000001
1000000000000000000001
1000001111111111000001
1000010000000000100001
1000010000000000100001
1000010000000000100001
1000010000000000100001
1000010000000000100001
1000001111111111000001
1000000000000000000001
1000000000000000000001
1111111111111111111111
